50 17
11111111111111111111111111111111111111111111111111
10000000000000000000000010000000000000000000000001
10111111111111111111110010011111111111111111111101
10100000000100000000000010000000001000000000000101
10101110000000001000000000000010001000000011110101
10100000011111111110000010000011111111100000000101
10000000010000000000000010000000000000000100000001
10011000010001110000001111100000001111100100010001
10000000010000000001111111111000200000100100010001
10000000000000000000001111100000000000000100010001
10001111111100000111100010000010000011111110000001
10100000010000000000000010000010000000000000000101
10100100010011111100000000000111111100000011110101
10100100000000000100000010000000000000110000000101
10111111111111111111110010011111111111111111111101
10000000000000000000000010000000000000000000000001
11111111111111111111111111111111111111111111111111
